0000000000000000000000088000000000000001000000
0000000000010000000000008000000000000000000000
0000001000000000000000008000000000000000000000
0000000000000000100000008800000000000000000000
0000000000000000000000008800000000000000000000
0000000000000000000000000880000000000000000000
0000000000000000000001000880000000000000000000
0000000000000000000000000888000010000000000000
0000000000000000000000000088000000000000000000
0000000000000000000000000088800000000000000000
0000000000000000000001000008880000008888000000
0000000000000000000000000008888888888888880000
0000000000000000000000000000888888888888888000
0000000000000000000000000000888888888888888000
0000000000000000000000000000088888888888888800
0000000000000000000000000000000888800000088800
0000000000000000000000010000000000000000008880
0000000000000000000000000000000000000000000880
0000000000000000000000000000000000000000000888
0000000000000000000000000000000000000000000088
0000000000000000000000000000010000000000000088
0000000000000000000000000000000000000000000008
0000000100000000000000000000000000000000000008
8000000000000000000000000000000000000000000000
8888800100000000000000000000010000000000000000
0008888800000000000000000000000000000000000000
0000088888000000000000000000100000000000000000
0000000888880000000010000000000000000000000000
0000000008888800000000000000000000000000000000
0000000000888880000000000000000000000000000000
0000000000188880000000000000000000000000000000
0000000000088888000000000000000000000000000000
0000000000088888100000000000010000000000000000
0000000000088888000000000000000000000000000000
0000000000088888000000000000000000000000000000
0000000000088880000000000000000000000000000000
0000000000888880000000000000000000000000000000
0000000000888880000000000000000000000000000000
0000000000888880000000000000000000000000000000
0000000000888880000000000000000000000000000000
0000000000088880000000000000000000000000000000
0000000000088888000000000000001000000000000000
0000000000008888800000000000000000000000000000
0000000000000088888000000000000000000000000000
0000000000000000888880000000000000000000000000
0000000000000000008888800000000100000000000000
